#############
####        #
#    ########
#           #
########    #
#           #
###### ######
#           #
#############